2 4 3 2 2 5 3 1 5 5 0 4 1 2
5 2 1 0 2 2 0 2 3 3 5 4 3 3
0 4 4 1 0 0 5 5 0 4 4 2 5 0
0 1 5 1 2 4 1 5 5 3 2 0 4 3
2 4 4 2 2 4 3 4 1 0 0 0 0 3
5 2 4 2 0 4 1 1 4 4 0 1 5 4